__S____________________.
__#____________________.
__#____________________.
__#########____######T_.
__________#____#_______.
__________#____#_______.
__________######_______.
_______________________.
_______________________.
_______________________.
_______________________.
_______________________.

